更 - gèng - more,
笑 - xiào - smile,
发表- fābiǎo - issue,
重要 - zhòngyào - important,
虎 - hǔ - tiger,
全体 - quántǐ - whole,
讲话 - jiǎnghuà - speech,
哭 - kū - cry,
强调 - qiángdiào - emphasize,
总结 - zǒngjié - summary,
运用 - yùnyòng - used,
党 - dǎng - political,
奋斗 - fèndòu - struggle,
经验 - jīngyàn - experience,
领导 - lǐngdǎo - leadership,
统一 - tǒngyī - unify,
集中 - jízhōng - concentrate,
坚持 - jiānchí - stick to,
以 - yǐ - according to,
引领 - yǐnlǐng - guide,
革命 - gémìng - revolution,
全面 - quánmiàn - overall,
为 - wéi-do,
制度 - zhìdù - institution,
伟大 - wěidà - mighty,
建设 -  jiànshè -  construct,
利益 - lìyì - benefit,
率 - lǜ - rate,
社会 - shèhuì - society,
腐败 - fǔbài - corrupt,
推进 - tuījìn - carry on,
完善 - wánshàn - refine,

